OOOOOOOOOOOOOOOOOOOOOOOOOOOOOO
OSFFFFFFFFFFFFFFFFFOFFFFFFFFFF
OFOOOOOOOOOOOOOOOFOFOOOOOOOOOO
OFFFFFFFOFFFFFFFFOFOFFFFFFFOFF
OOOOOOOFOOOOOOOOFOOOOOOOOFOOOO
OFFFFFFFOFFFFFFFOFFFFFFFOFFFFO
OFOOOOOOOOOFOOOOOOOOOOFOOOOOFO
OFOFFFFFFFFOFFFFFFFFFFFOFFFFFO
OFOFOOOOOOOOOOOOOOOOOOOOFOOOFO
OFOFFFFFFFFFFFFFFFFFFFFFFFOFFO
OFOOOOOOOOOOOOOOOOOOOOOOOOFOOF
OFFFFFFFFFFFFFFFFFFFFFFFFFFGFO
OOOOOOOOOOOOOOOOOOOOOOOOOOOOOO
