OOOOOOOOOOOOOOOOOOOOOOOOOOOOOOOOOOOOOOOOOOOOOOOOOOOOOOOOOOO
OSFFFFFFOFFFFFOFFFFFFFFFFFOFFFFFFFFFOFFFFFOFOFFFFFFFFFOFFFO
OFFFOFOOOFOFOOOFOFOOOOOFFOFFOFOOOOOFFFOOOFOFFFFFFOOOOFOOOFO
OFFFFFOFFFFFOFFFOFOFFFOFOFFFOFFFFFOFFFOFOFOFFFOFFFFFFFFFFFO
OOOFOFOFOOOFOFOOOFFFOFFFOFOOOOFOOFOOFOOFOFOFOOOFOOFOOOFOOOO
OFOFOFFFOFFFOFFFFFOFOFFFOFOFFFFFOFOFFFFFOFOFOFOFFFFFFFFFFFO
OFOFFFOFOFOOOFOFOOFFOFOOOFOFOOOFOFOOOOOFOFOFOFOFOOOFFOOOOFO
OFOFFFOFOFOFFFOFOFFFOFOFFFFFOFFFFFOFFFOFOFOFFFOFFFOFFFFFOFO
OFFOOFOOOFFFOOOFFFOOOOOFOFOOOFOOOOOFOFOFFFOFOFFFFFOFOFOOOFO
OFFFOFFFOFOFFFOFOFFFOFFFOFOFFFOFOFFFOFFFOFOFFFFFFFFFOFOFFFO
OFOFOOOFOFOOOFOFOOOFOFOOOFOFOOOFOFFFFFOFOFOFOOOOOOOOFFOFOOO
OFFFOFFFOFFFOFOFFFOFFFFFFFOFFFOFOFOFOFFFFFOFOFFFFFOFFFOFFFO
OFOFOFFOOFOFOFOFOFOOOOOOFFFFOFOFOFOFFOOFOFOOOFOOOFOFOOOOOFO
OFOFOFFFFFOFFFOFOFFFFFOFFFFFOFOFFFOFFFOFOFOFFFOFOFOFOFFFFFO
OFOFOOOFFFOOOOOFOFOOFFOFOOOFOFFFFOOOOFOFOFOFOOOFOFOOOFOOOOO
OFFFFFOFOFFFFFFFOFOFFFOFFFOFFFFFFFFFFFOFOFOFOFFFOFFFOFOFFFO
OFOOOOOFOOOOOOOOOFFFOFOOOFOOOOOFOFOOOOOFFFFFOFOOOOOFOFFFOFO
OFFFFFOFFFOFFFFFFFFFOFOFFFOFFFOFFFOFFFFFOFFFOFOFFFFFFFOFOFO
OFOFOFOOOFOFOOOOOOOFOOOFFOOFFFOFOFOOOOOOOOFOOFFFFOFOOFOFFFO
OFFFOFOFFFOFFFFFFFOFFFFFOFFFFFFFOFOFFFFFFFFFFFFFFFFFOFFFOFO
OFOOOFOFOOOFOFOOOFFOOFOFOFFOOOOFOFOFOOOOOOFFFOFOOFOFOFOOOFO
OFOFOFOFFFOFOFOFFFFFFFOFFFFFFFOFFFFFFFFFFFFFFFFFFFOFFFFFOFO
OFOFOFOOOFOFFFOOOFOOFOOFOFOOOFOFFFOFOFOOOFOOOOOFOFOOOOFFFFO
OFOFOFFFFFFFOFFFFFOFFFFFOFFFFFFFFFFFOFFFOFFFFFOFOFFFOFFFOFO
OFFFOFOFOFOFOOFOOFOFOOOFOFOFOOOOFOOFFFOFOFFFOFFFOFOFOFFOOFO
OFOFFFFFOFFFFFFFFFFFFFOFOFOFFFOFFFFFFFFFOFFFOFOFOFFFOFFFFFO
OFOFOOOOOFOOOOOFOOOOOOOFOFFFFFFOOOOOOFOOOFOOFFOFOOOOOFOFFFO
OFFFFFFFFFFFFFFFFFFFFFFFOFFFOFFFFFFFFFFFFFFFFFOFFFFFFFFFFGO
OOOOOOOOOOOOOOOOOOOOOOOOOOOOOOOOOOOOOOOOOOOOOOOOOOOOOOOOOOO
