OOOOOOOOOOOOOOO
OSFFFFFFFFFFFFO
OFOOFFFFFFFFFFO
OFFOOFFFFFFFFFO
OFFFOOFFFFFFFFO
OFFFFOFFFFFFFFO
OFFFFFFFFFFFFFO
OFFFFFOOFFFFFFO
OFFFFFFOOFFFFFO
OFFFFFFFOOFFFFO
OFFFFFFFFOFFFFO
OFFFFFFFFFFFFFO
OFFFOOFFFFFFFFO
OFFFFFFFFFFFFGO
OOOOOOOOOOOOOOO