OOOOOOOOOOOOOOO
OSFFFFFFFFFFFFO
OFFFFFFFFFFFFFO
OFOFFFFFFFFFOFO
OFFOFFFFFFFOFFO
OFFFOFFFFFOFFFO
OFFFFOFFFOFFFFO
OFFFFOFFFOFFFFO
OFFFFOFFFOFFFFO
OFFFOFFFFFOFFFO
OFFOFFFFFFFOFFO
OFOFFFFFFFFFOFO
OFFFFFFFFFFFFFO
OFFFFFFFFFFFFGO
OOOOOOOOOOOOOOO