OOOOOOOOOOOOOOOOOOOOOOOOOOOOOOOOOOOOOOOOOOOOOOOOOOOOOOOOOOO
OSFFFFFFFFFFOFFFFFFFOFFFFFFFFFFFOFFFFFFFOFFFOFFFFFOFFFFFFGO
OFOFOOOOFOOFOOOFOFOOOFOOOFOFOOFOOFFOOFOFOOOFOFOFOFOFOOOFOFO
OFOFOFFFFFOFFFOFOFFFFFFFOFOFOFFFFFFFOFFFFFFFOFOFOFOFFFOFFFO
OFOFFFOOOFOFOFOFOOOOOFOFOFOOFFOOOFOOOFOOOOOFOFOFOOOOOFOOOFO
OFFFFFFFFFOFOFOFFFFFFFOFOFFFFFOFFFFFOFFFOFFFOFOFFFFFFFOFFFO
OFOOOOOFOOOFFFOOOFOFOFOFOOOOFOOFOOOFOOOFOOOOOFOOFFOFOOOFOFO
OFOFFFFFOFFFOFFFOFOFOFFFFFFFFFOFOFFFFFOFFFFFFFOFFFFFOFFFOFO
OFOFOOOOOFOFOOOFFFOFOOOOFFOFOFOFOFOOFFOFOOOFFFOFOFOFOFOFOFO
OFFFFFFFFFOFOFFFOFOFFFOFFFFFFFFFOFFFOFOFFFOFFFOFOFOFFFFFOFO
OOOOOFOOOOOFOFOOOFOOOFOOFFOOOFOFFOOFOFOOOOOFOOOOOFFFOFOFOFO
OFFFFFFFOFFFOFFFOFOFOFFFOFFFOFOFFFOFFFOFFFOFFFFFFFOFFFOFFFO
OFOOOOOFOFOOOOOFOFOFFOOFOOOFOFOFOFOFFFOFFFOOOOOOFOOFOOOFOFO
OFOFOFFFOFFFFFFFOFOFFFFFOFFFFFOFOFFFFFFFOFFFFFOFFFFFOFFFOFO
OFOFOFOFOFOFOFOFOFOFOFOFOOOOOOOFOFOOOOOOOOOOFFOFOOOOOFOOOFO
OFOFFFOFFFFFOFFFOFFFOFOFFFFFFFFFOFOFFFOFFFFFOFFFOFFFFFOFFFO
OFOOOFOOOFOFOFOFOOOFOOOFOOFOOOOOOFOOOFOFOFOOOFOOOFOOOOOFOFO
OFFFOFFFFFOFOFOFFFFFFFOFOFFFFFFFOFFFOFOFOFOFFFOFFFFFOFFFOFO
OFOFOOFOFFOFOFOFOOFOOFOOOFFFOOOFOOOFFFOFOFFFFOFFOOOFFFOFOFO
OFOFOFFFFFFFFFFFOFFFFFOFFFOFOFFFOFFFOFOFOFFFOFFFOFFFFFOFFFO
OFOFOOOOOOOOOFOFOFOOOFOFFOOFOFOOOFOOFFOFOOOOOFOOOOFOOOOFOFO
OFOFFFFFFFOFFFOFFFOFFFFFFFFFFFFFFFOFFFOFOFFFFFFFFFFFFFFFFFO
OFFOFFOOOFFFOOFFOFFFOOOOOFFFFOOFOFOOOFOFFFOOFOOOOFOOOOOOFFO
OFFFOFFFOFOFOFFFFFFFFFFFFFOFOFFFOFOFFFOFOFFFFFFFFFFFFFFFOFO
OOOFOFOFOFOFFFFOOFFOOFOFOFFFFFFOOFOFOOOFFFOFOOOOOFOOOOOOOFO
OFFFFFOFOFOFFFOFFFFFFFOFOFOFFFFFFFOFFFFFOFFFFFFFOFFFFFOFFFO
OFOOFFOFOFFOOOOFOOOFOFOFOFOOFOOOOOOFOOOOOFOOFOOFFOOFFFFFFFO
OFFFFFOFOFFFFFFFFFFFOFFFFFFFFFFFFFFFFFFFFFFFFFFFFFFFFFFFOFO
OOOOOOOOOOOOOOOOOOOOOOOOOOOOOOOOOOOOOOOOOOOOOOOOOOOOOOOOOOO
