OOOOOOOOOOOOOOOOOOOOOOOOOOOOOO
OSFFFFFFFFFFFOFFFFFFFFFFFGFFFO
OFOOOOOOOOOOFOFOOOOOOOOOOFOOOO
OFOFFFFFFFFOFOFOFFFFFFFFOFFFFO
OFOFOOOOOOFOFOFOOOOOOOOFOOOOFO
OFOFOFFFFOFFFFFOFFFFFOFFFFFOFO
OFOFOOFOFOOOOOOFOOOOFOOOOFOFOO
OFFFOFOFFFFFFFFOFFFFOFFFFFOFFO
OOOOOFOOOOOOOOOOOOOFOOOOOOOOOO
OFFFFFOFFFFFFFFFFFFOFFFFFFFFFF
OOOOOOOOOOOOOOOOOOOOOOOOOOOOOO
