OOOOOOOOOOOOOOOOOOOOOOOOOOOOOO
OSFFFFFFFFFFFOFFFFFFFFFFFFFFFO
OFOOOOOOOOOOFOFOOOOOOOOOOOFOFO
OFOFFFFFFFFOFOFFFFFOFFFFFOFOFO
OFOFOOOOOOFOFOOOOOFOFOOOFOFOFO
OFOFOFFFFOFOFFFFOFOFOFFFOFOFOO
OFOFOOFOFOFOOOOFOFOFOOOOFOFOFO
OFFF OFOFFOFFF OFFOFFFFFOFOFOO
OOOOO OFOOOOOO OOOOOOOOOOOOFOO
OFFFFFOFFFFFOFFFFOFFFFFFFOFOFO
OFOOOOOOOOOOFOOOOOFOOOOOOFOGFO
OFFFFFFFFFFFFOFFFFFFFFFFFFOFOO
OOOOOOOOOOOOOOOOOOOOOOOOOOOOOO