OOOOOOOOOOOOOOOOOOOOOOOOOOOOOOOOOOOOOOOOOOOOOOOOOOOOOOOOOOO
OSFFFFOFOFFFFFOFFFFFFFFFFFFFFFFFFFFFOFFFFFFFFFOFFFFFFFOFFFO
OFOFOFOFOFOFOFOFOOOOOOOFOFFFOOOOOFFFOFOOOFFOOFOFFFOOOFOFOFO
OFFFFFOFOFOFFFFFOFFFFFOFOFFFOFFFFFOFFFOFFFOFFFOFOFOFFFFFOFO
OFOOOFOFOFOOOOFOOFOOOFOFOFOFOFOOOOOOOFOFFFOFOFOFOFOOOOOOOFO
OFOFOFFFFFFFFFFFFFOFFFOFOFOFFFOFFFFFOFFFOFOFFFOFOFFFFFFFOFO
OFOFFFOOOOFOOOFFOFOFOFOFOOOFOFFFFOOFOOOOOFOFOOOFFFOOOOOFOFO
OFFFFFFFFFFFFFOFOFFFOFFFFFFFOFFFOFOFFFFFOFOFFFFFFFFFFFOFOFO
OFOFOOOFOFOFOFOFOFFFOOOOOOOFOOOOOFFOOOOFOFOOOOOFOOOFOFOFOOO
OFOFFFOFOFFFOFFFFFOFFFFFFFOFFFFFFFFFOFOFFFFFFFFFFFFFFFOFFFO
OFOOOFOOFFOOOOOOOFOFOOOOOFFFOFFOOOOFFFOFOOOOOFOOOOOOOOOOOFO
OFFFOFFFFFOFFFOFFFFFOFFFOFFFFFFFFFFFFFFFFFOFFFFFFFFFFFOFFFO
OOOFOOOOOFOFOFOFFOOOOFOFOFFOOOOFOOOOOOOFOFFFOOOOOOOOOFOFOOO
OFFFOFOFFFOFOFFFOFFFFFFFOFFFOFFFFFFFFFFFOFOFFFFFOFFFOFOFFFO
OFOOOFOFOOOFOOOOOFOOOOOOOOOFOFOOOFOFOFOOOFOOOOOFOFOOOFOFFFO
OFOFOFFFOFFFOFFFFFFFFFOFFFFFOFFFOFFFOFOFOFOFFFOFOFFFFFOFFFO
OFOFOFOOOFOOOOOFOOOOOFOFOFOFOOOFOOFOOFOFOFOFOFOFOFFOOOOFOOO
OFOFOFFFFFFFFFOFOFFFOFFFOFFFOFFFOFFFFFFFOFOFFFOFOFFFFFOFFFO
OFFFOOOFFOOOFFFFOFOFOOOOOOOOOFOOOFFOOOOFFFOFOOOFFFOOFFOFOFO
OFOFFFOFOFFFFFOFOFOFFFFFFFFFOFFFOFOFOFFFFFFFOFFFOFFFOFFFOFO
OFOFOOOFOFOFOOOFFFOFOOOFOFOFOFOFFFOFOFOOOOOFOFOOOOOFOFFOOFO
OFOFFFFFFFOFFFFFOFOFOFFFOFOFOFOFFFOFFFFFOFFFFFOFFFFFOFOFFFO
OFOOOFOOOFOFOFOOOFOFFOOFOFOFOFOFOOOFFFOOOFOFOOOFOFOFOFOFOFO
OFFFOFOFFFFFOFOFFFFFFFOFOFOFOFFFFFFFOFOFFFOFFFOFOFFFFFOFOFO
OOOFOOOFOFOFOFOFFOOOOFFFOFFFOOOFFFOFFFOFFOFFOFFFOFOFOOOFOFO
OFOFFFFFOFFFOFOFOFFFFFOFFFOFFFFFFFFFFFOFFFFFFFOFOFOFOFFFOFO
OFOOFOOOOFOOOFOOOFOOOOOFOOOOOFOOOOOOOOOOOOOOOFOFOFOFOFOOFFO
OFFFFFFFFFFFFFFFFFOFFFFFFFFFFFFFFFFFFFFFFFFFFFOFFFFFFFOFFGO
OOOOOOOOOOOOOOOOOOOOOOOOOOOOOOOOOOOOOOOOOOOOOOOOOOOOOOOOOOO
