OOOOOOOOOOOOOOO
OSFFFFFFFFFFFFO
OFFFFFFFFFFFFFO
OFFOOOFFFFFFFFO
OFFOOOFFFFFFFFO
OFFOOOFFFFFFFFO
OFFFFFFFFFFFFFO
OFFFFFFFOOOFFFO
OFFFFFFFOOOFFFO
OFFFFFFFOOOFFFO
OFFOOOFFFFFFFFO
OFFOOOFFFFFFFFO
OFFFFFFFFFFFFFO
OFFFFFFFFFFFFGO
OOOOOOOOOOOOOOO