OOOOOOOOOOOOOOOOOOOOOOOOOOOOOOOOOOOOOOOOOOOOOOOOOOOOOOOOOOO
OSFFFFFFFFFFFFOFFFFFOFFFFFFFFFFFFFFFOFFFFFFFOFFFFFFFFFFFFFO
OFOOOFOFFFOOOFOOOFOFOFOOOOOOOFOOOOOFFFOOOFOFOFOOOFOOFOOFOFO
OFFFFFFFFFOFFFFFFFOFOFFFOFFFFFOFFFOFOFFFFFFFFFOFOFOFFFOFOFO
OFOOOFFFFFOOOOOOOOOFOOFFOOOOOOOFOFOOOOFOOFOOOOOFFFOFOOOFOFO
OFOFFFFFOFFFOFFFFFOFFFFFOFFFFFFFOFFFFFFFFFFFFFFFOFFFFFFFFFO
OFFFOOFOOOOFOFOFFFOFOFFOOFFFOFOOOOOOOFOOFOOFOOFFOFFOFFOFFOO
OFFFFFFFFFFFFFOFFFOFOFFFFFFFFFOFFFFFFFFFFFFFOFFFOFFFOFFFFFO
OFFOFOOOFFOFOOOFFFOFOFOFFOOOOFOFOFOOFOOOOFOOOFOOOOFFOFOOOFO
OFFFFFFFOFFFFFOFOFOFOFOFFFOFFFFFOFFFFFFFFFOFOFFFFFOFOFOFFFO
OFFOFFFFFFFOOFOFOOOFOFOFFFOOFOOOOOOOOOOFOFOFOOFFOOOFOFOFOOO
OFOFOFFFOFFFOFOFFFOFOFOFOFFFFFFFFFFFOFOFFFOFFFOFOFFFOFOFFFO
OFOFOFOOOOOFOFFOOFOFOOOFOOOFOOFOFOOFOFOFOFFFOFFFOFOFOFOOFFO
OFOFFFFFFFFFOFFFFFOFFFFFFFOFOFFFFFFFOFFFFFFFFFFFFFFFFFOFFFO
OFOFOOOOOFOFOFOFOOOOOFOFFFOFFFOOOOOFOFOOOOOOOOFFOOFOFOOFFFO
OFFFOFFFFFOFFFOFFFFFFFOFOFOFOFFFOFFFFFFFOFFFFFFFFFFFFFOFFFO
OOFFOFOOOOOOFOOFOOOFOFOOOFOFOFOFFFFOOOOOOFOFOOOOOOFOOFFFOFO
OFFFFFOFFFOFFFFFOFFFOFFFFFOFFFFFOFOFOFFFFFFFFFOFFFFFFFOFFFO
OFOFOFOFOFOFOOFOOFOOOFOFOFOFFOOOOFOFFFOFFOOFOOOFOFOFOOOOOFO
OFOFOFFFFFFFOFFFOFOFFFFFOFOFFFFFFFFFOFOFFFFFFFFFOFFFFFOFFFO
OFOOFFOOOFFOOFOFFFFFOOOOOFFFOFOFOOOFOFOOFFOFOFOFOOOFOFOFOFO
OFFFFFFFFFFFOFOFFFFFOFFFFFOFOFOFFFOFOFFFOFFFFFOFFFFFOFFFOFO
OOOFOOOOFFOFOFOOOFOFFFFOOOOFOFOOFFOOOOOFOOFOOFOOOFFOOOFOOFO
OFFFOFOFFFOFFFOFFFOFOFFFOFFFFFOFOFOFFFFFOFFFOFFFFFOFFFFFOFO
OFFFOFOFOOOFOOOFOOOFOFOFOFOOFOOFOFOFOFOOOFOFFFOFOFOFOOFFOFO
OFFFFFFFOFFFOFFFFFOFOFFFFFFFFFOFFFOFFFFFOFOFOFOFOFOFFFOFFFO
OFOFOOOFOFOFFFOOOFOFOOOOOFOOOFOFOOFFOFOFFFOFOFOFOFOOOFOFFFO
OFFFFFFFFFOFFFFFOFFFFFFFFFFFFFOFFFFFFFOFFFOFFFFFOFFFFFFFFGO
OOOOOOOOOOOOOOOOOOOOOOOOOOOOOOOOOOOOOOOOOOOOOOOOOOOOOOOOOOO
