OOOOOOOOOOOOOOOOOOOOOOOOOOOOOO
OSFFFFFFFFFFFFFFFFFFFFFFFFFFFF
OFOOOOOOFOOOOOOFOOOOOOFOOOOOFO
OFFFFF OFFFFF OFFFFF OFFFFF OF
OFFFFF OFFFFF OFFFFF OFFFFF OF
OFOOOOOOFOOOOOOFOOOOOOFOOOOOFO
OFFFFFFFFFFFFFFFFFFFFFFFFFFFFF
OFOOOOOOFOOOOOOFOOOOOOFOOOOOFO
OFFFFFOFFFFFOFFFFFOFFFFFOFFFFF
OFOOOOOOFOOOOOOFOOOOOOFOOOOOFO
OFFFFFFFFFFFFFFFFFFFFFFFFFFFGF
OOOOOOOOOOOOOOOOOOOOOOOOOOOOOO
