OOOOOOOOOOOOOOO
OSFFFFFFFFFFFFO
OFFFFFFFFFFFFFO
OFOOOOOOOOOOOOO
OFFFFFFFFFFFFFO
OFFFFFFFFFFFFFO
OOOOOOOOOOOOOFO
OFFFFFFFFFFFFFO
OFFFFFFFFFFFFFO
OFOOOOOOOOOOOOO
OFFFFFFFFFFFFFO
OFFFFFFFFFFFFFO
OOOOOOOOOOOOOFO
OFFFFFFFFFFFFGO
OOOOOOOOOOOOOOO