OOOOOOOOOOOOOOOOOOOOOOOOOOOOOOOOOOOOOOOOOOOOOOOOOOOOOOOOOOO
OSFFFFFFOFFFFFOFFFFFFFFFFFFFFFOFFFFFFFOFFFFFFFFFOFFFOFFFFFO
OFOFOFOFOFOFOFOFOOOFOFOFFOOFOFOOFOOFOFOOOOOOOFOFOOOFOFOOOFO
OFFFFFFFOFFFFFFFFFFFOFFFOFFFOFOFFFFFOFOFFFFFFFOFFFFFFFOFOFO
OOFFOOOFOOOOOOOOOOOFOOFOOFOFOFOFOOOOOFOFOFOOOFOFFOOOOFOFOFO
OFFFFFOFFFOFFFFFFFFFOFFFFFOFOFFFOFFFOFOFFFOFFFFFOFFFFFFFFFO
OOOOOFOOOFOFOOOOOOFOOFOFOOOFOOFOOOOFFFOOOFOFOOOFOFOFOOOFFFO
OFFFFFFFOFFFFFFFFFFFFFOFFFOFFFFFFFFFOFOFFFFFFFOFOFOFFFFFOFO
OFFOOOOFOFOFOOFOOOOOOFOFOFOFOOOOOOOFOFOFOOOOOFOFOFOFOOOFOFO
OFFFFFOFOFFFOFFFFFOFFFOFOFFFOFFFFFOFOFFFFFFFOFOFFFOFOFFFOFO
OFOFOFOFOOFFOFOFOFOFOOOOOFOOOFOOOFOOOFOFFFFFOFOOOOOOOFOFFFO
OFFFOFFFFFFFFFOFFFFFFFFFOFFFOFFFOFFFFFOFOFFFOFOFFFFFFFOFOFO
OFOFOOOOOFOOOOOOOFOOFFFFOFOFOOOFOOOOOOOFOFOOOFFFOFOOOFOFOFO
OFOFOFFFOFFFFFOFFFFFFFFFFFOFOFFFFFFFOFFFOFFFFFOFOFFFFFFFOFO
OFOFOFOOOOOOOFOFFOOFOOFOOFOFOFOOOFFFOFOOOOOOOOOOOOFFOOOFOFO
OFOFOFFFFFFFFFOFFFFFFFFFFFOFOFOFFFFFFFFFOFFFOFFFFFOFOFFFFFO
OFOFOOFOOFOFOFOFOOOFOFOFOOOOOFOFOOOOOOOFOFOFOOOFOFFFOFOOOFO
OFFFFFFFFFFFOFOFOFFFOFOFOFFFFFOFOFFFFFOFFFOFOFFFFFFFOFOFFFO
OFOFOFOOFFOFFOOFOFOFOFOOOFOOOOOFOFOFOOOOFFOFOFOOOFOOOFOFOOO
OFOFFFOFFFOFFFOFFFOFFFOFFFOFFFFFFFOFFFFFFFFFFFOFFFOFFFOFFFO
OFOFOOOFOFOOFFOFOFOOOOOFOOOFOOFOFFOOOOFOOFOOOFOOOOOFOOOOOFO
OFFFFFOFFFOFFFFFOFOFFFFFOFFFOFFFFFFFOFFFOFFFFFOFFFFFOFFFFFO
OOOOOFOFOOOFOOOFOFOFOFOFOOOOOFOFOOOFOFOFFOOOOFOFOOOOOFOOOOO
OFFFFFFFFFOFFFFFOFFFOFFFFFFFOFOFOFFFOFFFFFFFOFOFFFFFOFFFFFO
OFOFOOOOOFOOOFOFFOOOOFFOOFOFOFOFOOOOOFOOFOOFOOOFOOOFOOOFFFO
OFOFOFFFOFFFFFFFFFFFOFFFOFOFFFOFOFFFOFOFFFOFFFOFFFOFFFFFFFO
OFOFOFOFOFOFFFOFOOOFOOOOOFOOOOOFFFOFOFOFFFOOOFOOOOOOOFOFOFO
OFOFFFOFFFFFFFFFOFFFFFFFFFOFFFFFFFFFFFOFOFFFFFFFFFFFFFFFFGO
OOOOOOOOOOOOOOOOOOOOOOOOOOOOOOOOOOOOOOOOOOOOOOOOOOOOOOOOOOO
