OOOOOOOOOOOOOOO
OSFFFFFFFFFFFFO
OFOOOOOOOOOOOFO
OFOOOOOOOOOOOFO
OFOOOOOOOOOOOFO
OFOOOOOOOOOOOFO
OFOOOOOOOOOOOFO
OFOOOOOOOOOOOFO
OFOOOOOOOOOOOFO
OFOOOOOOOOOOOFO
OFOOOOOOOOOOOFO
OFFFFFFFFFFFFFO
OOOOOOOOOOOOOFO
OFFFFFFFFFFFFGO
OOOOOOOOOOOOOOO