OOOOOOOOOOOOOOO
OSFFFFFFFFFFFFO
OFFFFFFFFFFFFFO
OFFFFOFFOFFOFFO
OFFFFOFFOFFOFFO
OFFFFOFFOFFOFFO
OFFFFOFFOFFOFFO
OFFFFOFFOFFOFFO
OFFFFOFFOFFOFFO
OFFFFOFFOFFOFFO
OFFFFOFFOFFOFFO
OFFFFFFFFFFFFFO
OFFFFFFFFFFFFFO
OFFFFFFFFFFFFGO
OOOOOOOOOOOOOOO