OOOOOOOOOOOOOOOOOOOOOOOOOOOOOO
OSFFFFFOFFFFFFFFFFFFFOFFFFFFFO
OOOOOFOFOOOOOOOOOOOOFOOOOOOFOO
OFFFFFOFFFFFOFFFFFFFOFFFFFOFFO
OFOOOOOOOOOFOOOOOOOOOOOOOFOOFO
OFOFFFFFFFOFFFFFOFFFFFFFFOFOFO
OFOFOOOOOOFOOOOOFOOOOOOFOOFOFO
OFOFOFFFFOFFFFFOFFFFFOFOFFFFFO
OFOFOFOOOOOOOOOOOOOOFOFOOOOOOO
OFFFFOFFFFFFFFFFFFFOFFFFFOFFFF
OOOOOFOOOOOOOOOOOOFOOOOOFOOOFO
OFFFFFOFFFFFOFFFFFOFFFFFOFFFFO
OFOOOOOOOOOFOOOOOOOOOOOOFOOOFO
OFFFFFFFFFFFOFFFFFOFFFFFFFFFGF
OOOOOOOOOOOOOOOOOOOOOOOOOOOOOO
