OOOOOOOOOOOOOOOOOOOOOOOOOOOOOOOOOOOOOOOOOOOOOOOOOOOOOOOOOOO
OSFFFFFFFFOFFFFFFFOFFFFFFFFFFFFFFFFFOFFFFFFFOFFFFFFFFFFFFFO
OFOOOOOOOFOFOOOOOFOOOOOOOFOFOFFOOOOFOOOOOOOFOFOFOFOOOOOOOFO
OFFFFFFFOFOFFFOFOFFFFFFFOFOFOFFFFFOFFFFFOFFFFFOFFFOFFFOFFFO
OFOFOOOOOFOFOFFFOOOOOOOFOFFFOOOOOFOFFOFFOFOOOFOOOFOOOFOFOOO
OFOFFFFFFFOFOFOFFFFFFFFFOFFFFFOFFFOFFFOFOFFFOFFFFFFFOFFFOFO
OFOOOOOOOOOOOFOFOOOFFFOOOOOOOFOFOFOFOOOFOOOFFOOFFOOFOOFFOFO
OFOFFFFFFFFFFFOFFFFFFFFFFFFFOFOFFFFFOFFFFFFFFFOFOFOFFFFFFFO
OFFOOOOOOOOFOOOFOFFOFFOFOOFFOFOFOOOFOFOOOFOOOOOFOFOOOFOOFOO
OFFFOFFFFFOFFFOFFFOFFFOFFFOFFFOFFFOFOFOFFFOFFFOFOFOFFFOFFFO
OOOFOFOOOFOFOFOFOOOOOOOOOFOOOOOFOFOFFFOFOFOFOFOFOFOFOOOFOFO
OFOFOFFFOFFFOFFFOFFFFFFFFFFFFFFFOFOFFFOFOFFFOFOFFFOFFFFFFFO
OFOFOFOFFFOOOFOOOOFFOOOOOOOFOFOOFFOFOOOOOFOFOFOOOFOOOOOOOFO
OFFFOFOFOFFFFFOFFFFFOFFFFFFFFFOFFFOFFFOFFFOFFFFFFFOFFFFFOFO
OFOFOOOFFFOOOOFFFOOOOFOOOFOOFOOFOOOOFFOFOFOOFFFOOOFFOFOOOFO
OFFFOFFFOFFFFFFFOFFFOFFFOFOFFFFFOFFFOFFFFFFFOFOFFFFFOFFFFFO
OFOFOFOOOFOOOFOOOOOFOFOFOFOFOFFOFFOFFFOFOOOFOFOOOOOFOOOFOFO
OFFFFFOFOFFFOFFFOFFFOFOFFFOFFFFFFFFFFFFFFFFFOFFFFFOFFFOFOFO
OOOOOOOFFOOFOOOFOFOOOFOOFOOOOOOOOOOOOFOFOOOOOOOOOFOOOFOFOFO
OFFFFFFFFFFFFFOFOFFFFFOFFFOFFFFFFFFFOFFFOFFFFFOFFFOFFFFFOFO
OFFFOFOOOOOOOFOFOOOOFFOFFFFFOOOOOFOFOOOFOOOOFFOFOOOFOOOFOFO
OFOFOFFFFFFFOFOFFFFFFFFFOFFFOFFFFFFFOFFFFFFFOFFFFFFFOFFFOFO
OFOFOOOFOOOFOFOOOFOOOFOOOOOOOFOOOOOOOFOOOOOFOFOOOOOOOFOFOFO
OFOFFFOFFFOFOFFFFFOFFFFFOFFFFFFFFFOFFFOFFFOFOFFFOFFFFFOFOFO
OOOOOFOOOFOFOOOFOFOFOOOOOFOOOOOOOFOFOFOFOFOFOOOOOFOOOFOOOFO
OFFFFFOFFFOFOFFFOFFFOFFFFFFFFFFFFFFFOFFFOFOFFFFFFFOFFFOFFFO
OFOOOOOFOOOFFFOOOOOOOFOOOOOFOOOOFOOFOFOOOFFOOOOOOFOFFFOFOFO
OFFFFFFFFFOFFFFFFFFFFFOFFFFFFFFFFFFFFFFFOFFFFFFFFFFFFFFFFGO
OOOOOOOOOOOOOOOOOOOOOOOOOOOOOOOOOOOOOOOOOOOOOOOOOOOOOOOOOOO
