##############################
#S....2.....#.............#..#
#.######.####.#####.######.#.#
#......#......#...#......#.#.#
#.####.#########.#.#######.#.#
#....#.....3.....#.....#...#.#
####.###############.#.#.###.#
#....#.............#.#.#.....#
#.##.#.###########.#.#.#####.#
#.#..#.....#.....#...#.....#.#
#.#.#####.#.#.###########.#.#G
#.#.....#.#.#.............#..#
#.#####.#.#.###############.##
#.......#...#...............##
##############################
