############################################################
#S.........................................................#
#..........................................................#
#...#...#...#...#...#...#...#...#...#...#...#...#...#...#..#
##.######.######.######.######.######.######.######.######.#
#...#...#...#...#...#...#...#...#...#...#...#...#...#...#..#
#...#...#...#...#...#...#...#...#...#...#...#...#...#...#..#
#..........................................................#
##.######.######.######.######.######.######.######.######.#
#...#...#...#...#...#...#...#...#...#...#...#...#...#...#..#
#...#...#...#...#...#...#...#...#...#...#...#...#...#...#..#
#...#...#...#...#...#...#...#...#...#...#...#...#...#...#..#
##.######.######.######.######.######.######.######.######.#
#...#...#...#...#...#...#...#...#...#...#...#...#...#...#..#
#...#...#...#...#...#...#...#...#...#...#...#...#...#...#..#
#...#...#...#...#...#...#...#...#...#...#...#...#...#...#..#
##.######.######.######.######.######.######.######.######.#
#..........................................................#
#...#...#...#...#...#...#...#...#...#...#...#...#...#...#..#
#...#...#...#...#...#...#...#...#...#...#...#...#...#...#..#
##.######.######.######.######.######.######.######.######.#
#...#...#...#...#...#...#...#...#...#...#...#...#...#...#..#
#..........................................................#
#...#...#...#...#...#...#...#...#...#...#...#...#...#...#.G#
############################################################
