OOOOOOOOOOOOOOOOOOOOOOOOOOOOOOOOOOOOOOOOOOOOOOOOOOOOOOOOOOO
OSFFFFOFFFFFOFFFFFFFFFWFOFOFFFFFWFMFFFOFFFFFMWFFFFOFFFFFMFO
OFFFFFOFOOOFOOOFFFOOOOOMOFOFOFOOOOOOOWOFOOOFOFOFOFOOOFOOOMO
OFFFOFFFOFFFFFOFFFOFFFFFOFFFOFFMFFOFFFOFFFFFOFOFOFFFFFOMOFO
OOOOOOOOOFOOOFOOOFOOOFOOOOOFOOOOOFOFOOOFOOOOOFOFOOOWFFOFOFO
OFFFFFOFFFFFOFFFOFFFOFFFFFOFFFOFFFFMFFOFOFFFOFFFOFFFOFOFFFO
OFOOOFFFOOOFOOOFOFOFOOOOOWOOFOOFOOOOOFOFOFOFOOOOOFOOOFOFOOO
OFOFOFFFOFFFOFFFOFOFFFFFOFMFFWFFOFOFFFFFOFFFFFFFFFFFFFOFMFO
OFOWOOFFOFOFOFOOOFOOOOOFOOOOFOOFOFOFOFOFOOOOOFOFFMOFFOOOOOO
OFFFOFFFFFOFOFFFOFOFFFFFFFOMFFFFFFFFOFMFFFWWFFOFFFFFOMFFFFO
OFOOOFOFOOOOOOOFOFOFOFFFOWFOOOOOOFOOOFOOOOOOOFOFOFOOOFOOOFO
OFOFFFOFFFFFFFFFOFWFOFFFOWFFFFFFOWFFOFOFFFFFOFFFOFFFFFMFOFO
OOOFOOOMOFOOOOOOOOOOOFOWOOOMOOFFOOOFOFOFOOFOOFOFOOOOOOOWFFO
OFFFOFFFOFOFFFFFOFOFFFOFFFOFFFFFOFFFOFFFOFFFOFOFFFFFFFFMOFO
OFOOOOOFOFOOOFOFOFOFOOOFOFOFOOOOOFFOOOOOOFOFOOOOOFOOOOOOOFO
OMOFFFOFOFFFFFOMOFOFFFOFOFFFOFFFOMFFOFFFFFOFFFFFOFFFOFFFFFO
OFOFFFOFOOOOOOOFOFOOOFFFOOOOOOOWOOFFOFOOOOOOFOOFOOOOOFWOOMO
OFFFOFOFOFFFFFOFOFFFFFOFOFOFFFFFOFFFOFFFOFFFFMFFFFFFFFOMFFO
OFOOOFOFFFFOOFOFOOOFOOOFOFOFOFOFOFOOOOOMOOOOOOOOFOFOOOOOOOO
OFFFFFOFFFOFFFOFOFFFFFFFOFOFOFFFOFFFFFOFFFFFFFFFFFFWFFFFFFO
OFFOOOOOOOOFOOOFFFOOOFOOOFOFOFOOOFFFOWOOFOOOOFOOOFOOOOOOOMO
OFOFOFFFFFOFFFOFOFFFFFOFFFOMOFFFFFMFOFOFFWFFFMFFOFOFFFFFFFO
OFOFOFOOOFOFOOFFOFOOOFOOOFFFOOOOOOOFOFOFOOFOOOOFOOOFOOOFOFO
OFOFFFFFOMFWFFFFOFOFFFOFFFOFFFFFOFFFOFFFOFFFFFOFOFWFOFFFOWO
OMOOOOOOOFFOOFOOOOOFOOFFOOOOOOOFOFOFOOOOOFOFOOOFOMOOOFOOOFO
OFFFOFFFOFOFMFOFFFOFOFFFOFFFFFFFOFOFOFFFFFOFFFOMOFOFFFOFFFO
OFOFOFOWOOOFOOOFOFOFOFFOOFOOOOOOOOOFOFOOOOOFOFOFOFOFOOOOOFO
OFOFFFOFFFFFFFFFOFFFOFFFFFFFFFFFFFFFOFFFFFMFFFFFFFOFFFFFFGO
OOOOOOOOOOOOOOOOOOOOOOOOOOOOOOOOOOOOOOOOOOOOOOOOOOOOOOOOOOO
