OOOOOOOOOOOOOOO
OSOOOOOOOOOOOOO
OFOOOOOOOOOOOOO
OFOOOOOOOOOOOOO
OFOOOOOOOOOOOOO
OFOOOOOOOOOOOOO
OFOOOOOOOOOOOOO
OFFFFFFFOOOOOOO
OOOOOOOFOOOOOOO
OOOOOOOFOOOOOOO
OOOOOOOFOOOOOOO
OOOOOOOFOOOOOOO
OOOOOOOFOOOOOOO
OOOOOOOFFFFFFGO
OOOOOOOOOOOOOOO