OOOOOOOOOOOOOOOOOOOOOOOOOOOOOOOOOOOOOOOOOOOOOOOOOOOOOOOOOOO
OSFFFFFFOFFFFFFFFFOFFFFFFFFFOFFFFFFFFFOFFFFFFFFFOFOFFFFFFFO
OFOOFOOFOFOOOFOOOFFFOFOOOOFFFFOOOFOOOFOFOOOOOOOFFFOFOOOOFFO
OFFFFFOFFFOFOFFFOFFFOFFFFFOFOFFFFFFFFFFFOFOFFFOFOFOFFFFFFFO
OFOFFOOFOFOFOFOFFOOOOOFFOFOFOFOOOOOFOFOOOFOFFFFFOFOFOFOOFFO
OFOFOFFFFFFFFFOFFFFFFFFFOFOFOFFFFFOFFFOFFFFFFFOFOFFFOFFFFFO
OFOOOFOOOOFOOOOFOOOOOOOOOFOFOOFOOOOOOFOFOOOFOFFFOOOFOOOOOFO
OFFFFFOFFFFFFFOFFFFFOFFFOFOFOFFFFFFFFFOFFFOFOFOFOFFFFFFFFFO
OFOOFOOFFOOFOFOOOFOFFFOFOFOFOFFOOFOOOOOOOFFFOFOFOFFOOOOOFFO
OFFFFFFFOFFFOFOFFFOFFFFFFFFFOFFFFFFFOFFFOFFFOFOFFFOFFFOFFFO
OOOFOOOOOFOOOFOOOFFOOOFFOFOFOFOFOFOFOFOFFFOFOFOOOOOFOFOFOOO
OFFFFFFFFFOFFFOFFFFFFFFFOFOFFFFFOFOFOFOFFFFFFFOFOFFFOFOFFFO
OFOOOFOOOFOFOOOFFFOFOFOOOFOOOOOFOFOFOFOFOOOFOFOFOFOFOOOOOFO
OFFFOFOFFFOFFFFFOFOFOFFFFFOFFFFFOFOFOFOFFFFFOFFFOFFFFFFFOFO
OOOOOFOOOOOOOOOFOOOFOFOOOOOOFFOOFFFFOFOOOOOOOFFOFFFOFFOOOFO
OFFFFFOFFFFFFFOFOFFFOFFFFFFFFFFFFFFFFFOFFFOFFFFFFFOFOFFFOFO
OFOOOOOFFOOFOOOFOFOOOOOOOOOFOFOOOOOOOFOFOFOFOOOOOOOFOOOFFFO
OFFFFFFFOFFFFFOFOFOFFFFFFFFFOFOFFFFFFFFFFFFFOFFFFFFFOFFFOFO
OFOOOOFOOFOFOFOFOFFFOOOOOOOFOFOFOOOOFFFOOOOOOOOOFFOOOFOFOFO
OFOFFFFFFFFFOFFFFFOFOFFFOFFFOFOFFFFFFFFFFFFFFFFFFFOFFFOFOFO
OFFFOOOFOFOOOOOOOFOFOFOFFFOFOOOOOFOFOOFOOOOFOOOOOFOFOOOFOFO
OFOFOFFFFFOFFFFFFFOFFFOFOFOFOFFFFFOFOFFFFFFFFFFFFFOFFFOFFFO
OFFFOFOOOOOFFOOOOFOFOOOFOFOOOFOOOOFFOFFOOFOFOOOOFOOOOFOFFOO
OFOFOFOFFFFFOFFFFFFFFFOFFFFFOFFFOFFFFFFFFFOFOFFFFFFFOFOFFFO
OFOOOFFFOOOOOFOOOFOOOFOFOOOFOOOFOOOOOOOOFFOFOOOFOFOOOFOOFFO
OFFFOFFFFFFFFFOFFFOFFFFFFFOFFFOFFFOFFFFFFFFFOFFFOFOFFFOFFFO
OOFFOFOFOFOFOOFFOFOOOOOOOFOFOFOFOFOFFFOOOOFFOFOOOFOFOOOFFFO
OFFFFFOFFFOFFFFFFFFFFFFFFFFFOFFFFFFFFFFFFFFFFFOFFFOFFFFFFGO
OOOOOOOOOOOOOOOOOOOOOOOOOOOOOOOOOOOOOOOOOOOOOOOOOOOOOOOOOOO
