OOOOOOOOOOOOOOOOOOOOOOOOOOOOOO
OSFFFFFFFFFFFFFFFFFFFFFFFFFFG 
OFOOOOOOFOOOOOOFOOOOOOFOOOOOFO
OFFFFF OFFFFF OFFFFF OFFFFF OF
OFOOOOOOFOOOOOOFOOOOOOFOOOOOFO
OFFFFFFFFFFFFFFFFFFFFFFFFFFFFF
OFOOOOOOFOOOOOOFOOOOOOFOOOOOFO
OFFFFFOFFFFFOFFFFFOFFFFFOFFFFF
OFOOOOOOFOOOOOOFOOOOOOFOOOOOFO
OFFFFFFFFFFFFFFFFFFFFFFFFFFFFF
OOOOOOOOOOOOOOOOOOOOOOOOOOOOOO
