OOOOOOOOOOOOOOO
OSFFFFFFFFFFFFO
OFFFFFFFFFFFFFO
OFFOOOFFFOOOFFO
OFFOOOFFFOOOFFO
OFFFFFFFFFFFFFO
OFFFFFFFFFFFFFO
OFFOOOFFFOOOFFO
OFFOOOFFFOOOFFO
OFFFFFFFFFFFFFO
OFFFFFFFFFFFFFO
OFFOOOFFFOOOFFO
OFFFFFFFFFFFFFO
OFFFFFFFFFFFFGO
OOOOOOOOOOOOOOO