OOOOOOOOOOOOOOO
OSFFFFFFFFFFFFO
OFRRRRRRRRRRRFO
OFRMMMMMMMMMRFO
OFRMWWWWWWWMRFO
OFRMWWOOWWMRFFO
OFRMWOFFOWMRFFO
OFRMWOFFOWMRFFO
OFRMWWOOWWMRFFO
OFRMWWWWWWWMRFO
OFRMMMMMMMMMRFO
OFRRRRRRRRRRRFO
OFFFFFFFFFFFFFO
OFFFFFFFFFFFFGO
OOOOOOOOOOOOOOO