OOOOOOOOOOOOOOO
OSRRRRRRRRRRRRO
ORMMMMMMMMMMMRO
ORMWWWWWWWWWMRO
ORMWFFFFFFFWMRO
ORMWFOOOFFFWMRO
ORMWFOFFFFFWMRO
ORMWFOFFFFFWMRO
ORMWFOOOFFFWMRO
ORMWFFFFFFFWMRO
ORMWWWWWWWWWMRO
ORMMMMMMMMMMMRO
ORRRRRRRRRRRRRO
OFFFFFFFFFFFFGO
OOOOOOOOOOOOOOO