OOOOOOOOOOOOOOOOOOOOOOOOOOOOOOOOOOOOOOOOOOOOOOOOOOOOOOOOOOO
OSFFOROFFFWFFFMFRFMFFFFFOFFFFFOWFWFFMMFRFFFWFFOFFFFMFFOFFFO
OFOFOFWFOOOOFOOOOOOOFFOFOFOOOOOROOOOOOFOOOMFOFOROOOOOFOMOFO
OFFFFFOMMFFFFFFFFFOFMFOFOFFFOFFFOFFFOFFFFFMFOFFFOFFFOFFFOFO
OMOFOFOFOOOOFOOOOFOFOOOFOOOFOFFFOFOFORFFRFOOOOOOOFFOOOOFOMO
OFFFOFFFMRFMFFOFFFOWOFOFOFFFOFOFFFOFOROFFFRWOFFFFFFFFFOFFFO
OFOFOOOOOFOOOOOFOOOFOFOFOFFOOFOFFOOFOFOOOFOFOFOFOOOOFFFOFFO
OFFFOFFFFFFFFFFFOFFFOFFFFFOFFFMFOFFFFFOFFFFFOWFFOFFROFFFOFO
OFFOOFFOOOOFFOOOOFOOOFOFOFOFOOOOOOOOOOOFOOOOOFOFOFOROOOFOFO
OFFFFFRFFFFFOFWFFFOFOROFOFFFOFFFMFFFOFFFOFFFOFOFFFOFMFOFFFO
OFOFOOOOOOOOOFOOOOFFOMOFOFOOOFOOFOOFOFOOOOOFOROFOOOFOFOFOOO
OFFFFWFFFFOFFFOFOFFFFFOFOFOFOFOFFFFFFFOFFFFFOMOFMFOFFFFFFWO
OFOOOFOFOFOFOOOFOFOOOOOFOFFFOFOFOFFOFOOOOWOOOFOOOFOFOOFMOFO
OFOFFFFFFFFFOFMFOFFFFFFFFFOFOFOFFFOMFRWMFMFFFFMFFFFFOFFWOFO
OFOOOOOOOFOROFOFOFOFOFOFFOOROFFFOFOFOOFFOFFFOOOOOOFFOFOOOFO
OFFFOFFFFFFFFFFFOMWFOFFFFFFFOFOFOFFFOFFFOFORFFFFFFFFOWFFFFO
OOOFFFOOOOOMWFOOOOOFOFOOOMOFOMOMOOOOORFOOMOOFOOFOROFOOFWOFO
OFOFOFOFFFOFOMFMFMOFOFFFFFOFOFFFFFFWOWFFOFOFFFFFOFFFOFFFOFO
OFOFOFOFOFOFOOOFOOOFOFOOOFOFOOOOFFOFOFFFOFOFOOOOOFFFOMMOOFO
OFFFOFOFOFOFOMOFFFFFORFFFFOFFFOFFFOFOFOFFFFFOFFFFFOFFFOFFFO
OFOOFFOOOFOFOFOFOOWFRFOFOFOOOFOFFFOFOFOOFOOFOFOOOFFFOOOOOFO
OFFFFFOFFFOFMFFFOFFFFFMFOFFFFFOFFFFFOFOFFFFFOFFFOFOFFFFFWWO
OFOOOFOFOOOFOFOFOFOOOOOWOOOOOFFOOFOOOFOFOFOOOFFFOOOOOOOOOFO
OFFFOFOFFFFFFFOFFFOFFFOFFFFFFFFWFFFFFFOFOFOFFFOFFFFFFFFMOWO
OFOFOFOFFOOOOOOWOOOFOFOOOOOMOOOOOOFFOOOFOFOFOOOOOOFOFFOFOFO
OFOFFFOFFFFFOFFFFMFFOFFFFFFFOFFFFFFFOWOFFFFFMFFFFMFFFFOFFFO
OFFOOOFFOFFFOFOOOOOOOOFOOFOOOMFOFFOMOFOFOOOFOOOFOFOOOOOFOFO
OFFFFFFMFFOFFFOFFFFFFFFMFFFFFFOFFWRFOWFFFFFFFFFROFFFFFFFFGO
OOOOOOOOOOOOOOOOOOOOOOOOOOOOOOOOOOOOOOOOOOOOOOOOOOOOOOOOOOO
