OOOOOOOOOOOOOOOOOOOOOOOOOOOOOOOOOOOOOOOOOOOOOOOOOOOOOOOOOOO
OSWFFFFMFFFFFFFFFFFFOFFMFFOFWFFWFFFFFFFFFFFFFFFFFFFFFFFFFFO
OFOFFOFOOOOFOFOFOOOFOOOOOFOMOOOFFOOOOFOFFOOOFFOOOOFOOOOOOFO
OFOFOFFFFFOFFFOFOWOFMFFFOFOFFFOFFFOFFFOFFFFFOFFFFFFFFFOFOFO
OFOOFFOOFFOFOFOFOFOOOOOFOFOFOMMFOFOFOOOOFOOFOOOFFFOOOFOFOFO
OFFFWFOFOFOFOFFFFFFFFFFFOFOFOFFFOFFFFMFFFFFWOMOFOFOFFFFFOFO
OOOOOOFFOFOOOFOOOFOOOOFOOFOFOFOOOOOFWFOFOOOOOWFFOFOFWOOOOFO
OFFFOFFFOFFFFFOFOMFFFFFFFWFMFFFFFFOFFFOFOFFFFFOFOFFFFFFFOFO
OFOFOFOOOOOOFOOFOOOFOFOOOOOFOOOFOFOFOOOFOFOOOFOFOOOOOOOFOFO
OFFFFFOFFFFFFFFFWFOFOFOFWFFWFFOMOFOFFFFFOFOFOFOFFFFFMFOFFFO
OFOOOOOFOFOOOOOFOOFFOFOFOFOOOFOFOFOOOOOOOFFFOFOOOOFFFFOFOOO
OFOFFFOFOFFFFFOFFFFFOFFFOFFFFFWFOFFFFFFMOFFFOWWFFMOFOFOFFFO
OFOMOFOFOOOOOFOFOOOWOFFOOFOFOOOOOOOOOOOFOOOOOFOFOWOOOFOFOFO
OFFFFFOMOFFMOFFFWFFFFFFFMFFFFWOFFFFFOFOFFFFFOFOFOFFFFFOFOFO
OWOFOFOFFFOMFFOOFFFFOFOOFOOOOOFFOFOFOFOOOFFFOMOFOOFOOFOFFFO
OFFFOFWFOFOFFFOFFFOFFFOFFFFFFMFFOFOFOFFFFFFFFFOFOFWFFFFFOFO
OFOOOOOOOMOFOOOFFWOOFOOFOOMFOWOOOFOFOOOOOOOOOOOWOFOOOOFMOFO
OFOFFFFFFFFMFFFFOFFFFFOFWFOFFFOFFFOWFWOWFFFFFWFFOFFFOFFFOFO
OFFFOOFOOOOOOOFOOFOOFFOFOFOOOOOFOFOOOMOFOFOFFFOFOOOFOWOFOFO
OFOFFFFFFFOFFWFFOFOFFFOFFFFMFFOFOFWFOFOFOFFFWWFFFFWFFFOFOFO
OFOOOFOFOMOFOFFFOFOFOOOOOFFOOFMFOFOFFFOFWOOFOOOOOOOOOOOFOFO
OFFFFWOFOFFFOFFWFFOFFFFFOFFFOFOFFFFFOWOWFFOFFFFFFFFFFFFFOFO
OOOOOFOFOFOFOOOOOOOMOOFMOFOOOFWWFOOFOFOOOFOOOFOFOWOFOWOOOFO
OFFFOFFFOFOMFFOMMFFFOFFMOFFFFFOWOWOFFWFFFFOFOFMFMFOFOFFFFFO
OFOFOOOOOFOFOFOFOFFWOFOOFFOOOOOFOFOOOOOFOOOFOOOOOOOFOOFFFMO
OFOFFFOMWWOFOFOFOMOFOFFFFFFWFWOFOFFFOFFFOFOFFFFFMFOFOFFFFFO
OFOOFWOFFOOOFFOFFFOOOOFFOFOFOFOFOFOFOOOFOFOFOOFOFFOFOFWOOWO
OFFFOFFMFFFFWFOFOMFWFFFMFFFFOFFFMFOFFFFFWFFFFFFFOFFFFFOFFGO
OOOOOOOOOOOOOOOOOOOOOOOOOOOOOOOOOOOOOOOOOOOOOOOOOOOOOOOOOOO
